sb,__,__,__,__,__,__,__,__,__,__,__,__,__,__,__,__,__,__,__,__,__,__,__,__,__,__,__,__,__,__,__,__,__,__,__,__,__,__,__,__,__,__,__,__,__,__,__,__,__,__,__,__,__,__,__,__,__,__,__,__,__,__,__,__,__,__,__,__,__,__,__,__,__,__,__,__,__,__,__,__,__,__,__,__,__,__,__,__,__,__,__,__,__,__,__,__,__,__,__,__,__
sb,__,__,__,__,__,__,__,__,__,__,__,__,__,__,__,__,__,__,__,__,__,__,__,__,__,__,__,__,__,__,turtle,__,__,__,__,__,__,__,__,__,__,__,__,__,__,__,__,__,__,__,__,__,__,__,__,__,__,__,__,__,__,__,__,__,__,__,__,__,__,__,__,__,__,__,__,__,__,__,__,__,__,__,__,__,__,__,__,__,__,__,__,__,__,__,__,__,__,__,__,__,__
sb,__,__,__,__,__,__,__,__,__,__,__,__,__,__,__,__,__,__,__,cb,__,__,__,__,__,__,__,__,__,__,__,__,__,__,__,__,__,__,__,__,__,__,__,__,__,__,__,__,__,__,__,__,__,__,__,__,__,__,__,__,__,__,__,__,__,__,__,__,__,__,__,__,__,__,__,__,__,__,__,__,__,__,__,__,__,__,__,__,__,__,__,__,__,__,__,__,__,__,__,__,__
sb,__,__,__,__,__,__,__,__,__,__,__,__,__,__,__,__,__,__,__,__,__,__,__,__,__,__,__,__,__,__,__,__,__,__,__,__,__,__,__,__,__,__,__,__,__,__,__,__,__,__,__,__,__,__,__,__,__,__,__,__,__,__,__,__,__,__,__,__,__,__,__,__,__,__,__,__,__,__,__,__,__,__,__,__,__,__,__,__,__,__,__,__,__,__,__,__,__,__,__,__,__
sb,__,__,__,__,__,__,__,__,__,__,__,__,__,__,__,__,__,__,__,__,__,__,__,__,__,__,__,__,__,__,__,__,__,__,__,__,__,__,__,__,__,__,__,__,__,__,__,__,__,__,__,__,__,__,__,__,__,__,__,__,__,__,__,__,__,__,__,__,__,__,__,__,__,__,__,__,__,__,__,__,__,__,__,__,__,__,__,__,__,__,__,__,__,__,__,__,__,__,__,__,__
sb,__,__,__,__,__,__,__,__,__,__,__,__,__,__,__,__,__,__,__,__,__,__,__,__,__,__,__,__,__,__,__,__,__,__,__,__,__,__,__,__,__,__,__,__,__,__,__,__,__,__,__,__,__,__,__,__,__,__,__,__,__,__,__,__,__,__,__,__,__,__,__,__,__,__,__,__,__,__,__,__,__,__,__,__,__,__,__,__,__,__,__,__,__,__,__,__,__,__,__,__,__
sb,__,__,__,__,__,__,__,__,__,__,__,__,__,__,__,__,__,cb,bb,redmushroom,bb,cb,__,__,__,__,__,__,__,__,star,__,__,__,__,__,__,__,__,__,__,__,__,__,__,__,__,__,__,__,__,__,__,__,__,__,__,__,__,__,__,__,__,__,__,__,__,__,__,__,__,__,__,__,__,__,__,__,__,__,__,__,__,__,__,__,__,__,__,__,__,__,__,__,__,__,__,__,__,__,__
sb,__,__,__,__,__,__,__,__,__,__,__,__,__,__,__,__,__,__,__,__,__,__,__,__,__,__,__,__,__,__,__,__,__,__,__,__,__,__,__,__,__,__,__,__,__,__,__,__,__,__,__,__,__,__,__,__,__,__,__,__,__,__,__,__,__,__,__,__,__,__,__,__,__,__,__,__,__,__,__,__,__,__,__,__,__,__,__,__,__,__,__,__,__,__,__,__,__,__,__,__,__
sb,__,__,__,__,__,__,__,__,__,__,__,__,__,__,__,__,__,__,__,__,__,__,__,__,__,__,__,__,__,__,__,__,__,__,__,__,__,__,__,__,__,__,__,__,__,__,__,__,__,__,__,__,__,__,__,__,__,__,__,__,__,__,__,__,__,__,__,__,__,__,__,__,__,__,__,__,__,__,__,__,__,__,__,__,__,__,__,__,__,__,__,__,__,__,__,__,__,__,__,__,__
sb,__,__,__,__,__,__,__,__,__,__,__,__,__,__,__,__,__,__,__,__,__,__,__,__,__,__,__,__,__,__,__,__,__,__,__,__,__,__,__,__,__,__,__,__,__,__,__,__,__,__,__,__,__,__,__,__,__,__,__,__,__,__,__,__,__,__,__,__,__,__,__,__,__,__,__,__,__,__,__,__,__,__,__,__,__,__,__,__,__,__,__,__,__,__,__,__,__,__,__,__,__
sb,__,__,__,__,__,__,__,__,__,__,__,__,__,__,__,__,__,__,__,__,__,__,__,__,__,__,__,__,__,__,__,__,__,__,__,__,__,__,__,__,__,__,__,__,__,__,__,__,__,__,__,__,__,__,__,__,__,__,__,__,__,__,__,__,__,__,__,__,__,__,__,__,__,__,__,__,__,__,__,__,__,__,__,__,__,__,__,__,__,__,__,__,__,__,__,__,__,__,__,__,__
sb,__,__,__,__,__,__,__,__,__,__,__,__,__,__,__,__,__,__,__,__,__,__,__,__,__,__,__,__,__,__,__,__,__,__,__,__,__,__,__,__,__,__,__,__,__,__,__,__,__,__,__,__,__,__,__,__,__,__,__,__,__,__,__,__,__,__,__,__,__,__,__,__,__,__,__,__,__,__,__,__,__,__,__,__,__,__,__,__,__,__,__,__,__,__,__,__,__,__,__,__,__
sb,__,__,__,__,__,__,__,__,__,__,__,__,__,__,__,p,__,__,goomba,goomba,__,__,__,p,__,__,__,__,__,__,__,__,__,__,__,__,__,__,__,__,__,__,__,__,__,__,__,__,__,__,__,__,__,__,__,__,__,__,__,__,__,__,__,__,__,__,__,__,__,__,__,__,__,__,__,__,__,__,__,__,__,__,__,__,__,__,__,__,__,__,__,__,flag,__,__,__,castle,__,__,__,__
fb,fb,fb,fb,fb,fb,fb,fb,fb,fb,fb,fb,fb,__,__,fb,fb,fb,fb,fb,fb,fb,fb,fb,fb,fb,fb,__,__,fb,fb,fb,fb,fb,fb,fb,fb,fb,fb,fb,fb,fb,fb,fb,fb,fb,fb,fb,fb,fb,fb,fb,fb,fb,fb,fb,fb,fb,fb,fb,fb,fb,fb,fb,fb,fb,fb,fb,fb,fb,fb,fb,fb,fb,fb,fb,fb,fb,fb,fb,fb,fb,fb,fb,fb,fb,fb,fb,fb,fb,fb,fb,fb,fb,fb,fb,fb,fb,fb,fb,fb,fb
fb,fb,fb,fb,fb,fb,fb,fb,fb,fb,fb,fb,fb,__,__,fb,fb,fb,fb,fb,fb,fb,fb,fb,fb,fb,fb,__,__,fb,fb,fb,fb,fb,fb,fb,fb,fb,fb,fb,fb,fb,fb,fb,fb,fb,fb,fb,fb,fb,fb,fb,fb,fb,fb,fb,fb,fb,fb,fb,fb,fb,fb,fb,fb,fb,fb,fb,fb,fb,fb,fb,fb,fb,fb,fb,fb,fb,fb,fb,fb,fb,fb,fb,fb,fb,fb,fb,fb,fb,fb,fb,fb,fb,fb,fb,fb,fb,fb,fb,fb,fb
fb,fb,fb,fb,fb,fb,fb,fb,fb,fb,fb,fb,fb,__,__,fb,fb,fb,fb,fb,fb,fb,fb,fb,fb,fb,fb,__,__,fb,fb,fb,fb,fb,fb,fb,fb,fb,fb,fb,fb,fb,fb,fb,fb,fb,fb,fb,fb,fb,fb,fb,fb,fb,fb,fb,fb,fb,fb,fb,fb,fb,fb,fb,fb,fb,fb,fb,fb,fb,fb,fb,fb,fb,fb,fb,fb,fb,fb,fb,fb,fb,fb,fb,fb,fb,fb,fb,fb,fb,fb,fb,fb,fb,fb,fb,fb,fb,fb,fb,fb,fb
fb,fb,fb,fb,fb,fb,fb,fb,fb,fb,fb,fb,fb,__,__,fb,fb,fb,fb,fb,fb,fb,fb,fb,fb,fb,fb,__,__,fb,fb,fb,fb,fb,fb,fb,fb,fb,fb,fb,fb,fb,fb,fb,fb,fb,fb,fb,fb,fb,fb,fb,fb,fb,fb,fb,fb,fb,fb,fb,fb,fb,fb,fb,fb,fb,fb,fb,fb,fb,fb,fb,fb,fb,fb,fb,fb,fb,fb,fb,fb,fb,fb,fb,fb,fb,fb,fb,fb,fb,fb,fb,fb,fb,fb,fb,fb,fb,fb,fb,fb,fb
fb,fb,fb,fb,fb,fb,fb,fb,fb,fb,fb,fb,fb,__,__,fb,fb,fb,fb,fb,fb,fb,fb,fb,fb,fb,fb,__,__,fb,fb,fb,fb,fb,fb,fb,fb,fb,fb,fb,fb,fb,fb,fb,fb,fb,fb,fb,fb,fb,fb,fb,fb,fb,fb,fb,fb,fb,fb,fb,fb,fb,fb,fb,fb,fb,fb,fb,fb,fb,fb,fb,fb,fb,fb,fb,fb,fb,fb,fb,fb,fb,fb,fb,fb,fb,fb,fb,fb,fb,fb,fb,fb,fb,fb,fb,fb,fb,fb,fb,fb,fb
fb,fb,fb,fb,fb,fb,fb,fb,fb,fb,fb,fb,fb,__,__,fb,fb,fb,fb,fb,fb,fb,fb,fb,fb,fb,fb,__,__,fb,fb,fb,fb,fb,fb,fb,fb,fb,fb,fb,fb,fb,fb,fb,fb,fb,fb,fb,fb,fb,fb,fb,fb,fb,fb,fb,fb,fb,fb,fb,fb,fb,fb,fb,fb,fb,fb,fb,fb,fb,fb,fb,fb,fb,fb,fb,fb,fb,fb,fb,fb,fb,fb,fb,fb,fb,fb,fb,fb,fb,fb,fb,fb,fb,fb,fb,fb,fb,fb,fb,fb,fb
fb,fb,fb,fb,fb,fb,fb,fb,fb,fb,fb,fb,fb,__,__,fb,fb,fb,fb,fb,fb,fb,fb,fb,fb,fb,fb,__,__,fb,fb,fb,fb,fb,fb,fb,fb,fb,fb,fb,fb,fb,fb,fb,fb,fb,fb,fb,fb,fb,fb,fb,fb,fb,fb,fb,fb,fb,fb,fb,fb,fb,fb,fb,fb,fb,fb,fb,fb,fb,fb,fb,fb,fb,fb,fb,fb,fb,fb,fb,fb,fb,fb,fb,fb,fb,fb,fb,fb,fb,fb,fb,fb,fb,fb,fb,fb,fb,fb,fb,fb,fb
fb,fb,fb,fb,fb,fb,fb,fb,fb,fb,fb,fb,fb,__,__,fb,fb,fb,fb,fb,fb,fb,fb,fb,fb,fb,fb,__,__,fb,fb,fb,fb,fb,fb,fb,fb,fb,fb,fb,fb,fb,fb,fb,fb,fb,fb,fb,fb,fb,fb,fb,fb,fb,fb,fb,fb,fb,fb,fb,fb,fb,fb,fb,fb,fb,fb,fb,fb,fb,fb,fb,fb,fb,fb,fb,fb,fb,fb,fb,fb,fb,fb,fb,fb,fb,fb,fb,fb,fb,fb,fb,fb,fb,fb,fb,fb,fb,fb,fb,fb,fb
